"DATA";"DOCUMENTO";"HISTORICO";"VALOR";"SALDO"
"2019/02/20";3;"TRANSFERENCIA A CREDITO - 00019 0009933310 DANIEL PEREIRA GUIMARAES EPP";"451.2";"756.63"
"2019/02/22";1;"COMPRA CARTAO - COMPRA no estabelecimento STUDIO Z               J";"-59.99";"696.64"
"2019/02/22";4;"PAGAMENTO DE TITULO - Auto escola";"-365.9";"330.74"
"2019/02/22";2;"INTERPAG DEB - 00019 0008183325 ANTONIO ALVES PENA";"-9.05";"321.69"
"2019/02/22";2;"INTERPAG CRED - 00019 0008183325 ANTONIO ALVES PENA";50;"371.69"
"2019/02/25";1;"COMPRA CARTAO - COMPRA no estabelecimento PAPELARIA UNIVERSO     J";"-36.3";"335.39"
"2019/02/25";1;"COMPRA CARTAO - COMPRA no estabelecimento MERC PRUDENTINA        J";"-6.99";"328.4"
"2019/02/26";1;"COMPRA CARTAO - COMPRA no estabelecimento PAPELARIA UNIVERSO     J";-8;"320.4"
